[LEVEL]
XX XXXXXXXXXXXXXXX    E XX
XX XXXXCXXXXXXXXXX XXCXXXX
XX XXXDDXXXXXDXXXX XXXXXXX
XX CXXDDXXXXXDXXXX XXXXXXX
XXSXXXDDCXXXXDCXXX XXDDDXX
XX XXXDDXXXXXDXXXX XXDDDXX
XX XXXDDXXXXXDXXXX XXDDDXX
XX  XXXXXXXXCXCXXX XXXXXXX
XXX XXXXXXXXXXXXXX XXXXXXX
XXX B   XXXXXXXXXX XXXXXXX
XXXXXXX XXXXXXXXXX XXXXXXX
XXDXXXX XXXXXXXXXX XXXXDXX
XXDDXXX      P     XXXDDXX
XXXXXXXXXXXXXXXXXXXXXXXXXX
[LEVEL]
XXXXXXXXXXXXXXXXXXXXXXXXXX
XX   E     XXXXCXCXXXX SXX
XXXXXXXXXX XXXXXXXXXXX XXX
XXXDDXXXXX XXXDDDDDXXX XXX
XXXDDXXXXX XXXDDDDDXXX XXX
XXCDDCXXXX XXXXXXXXXXXBXXX
XXDDDDXXXX XXXXXXXXXXX XXX
XXDDDDXXXX XXXCXXXXXXX XXX
XXXDDXXXXX XXXDDXXX    XXX
XXXCCXXXXX XXDDDDXX XXXXXX
XXXXXXXXXX XXXDDXXX XXXXXX
XXDXXXXXXX XXXXXXXX XXXXXX
XXDDXXXXXX    P     XXXXXX
XXXXXXXXXXXXXXXXXXXXXXXXXX
[LEVEL]
XXXXXXXXXCXXCXXXCXXXXXXXXX
XX  S   XXXXXXXXXX   E  XX
XXDDXXX XXDXXXDXXX XXCCXXX
XXDXXXX XXDXXXDXXX XXDDXXX
XXXCCXX XXDXXXDXXX XDDDDXX
XXDDDDX XXDXXXDXXX XDDDDXX
XXDDDDX XXDXXXDXXX XXDDXXX
XXXDDXX     B      XXDDXXX
XXXDDXXXXXXX XXXXXXXXXXXXX
XXXXXXXXXDXX XXDXXXXXXXXXX
XXXXXXXXXDXX XXDXXXXXXXXXX
XXDXXXXXXDXX XXDXXXXXXXDXX
XXDDXXXXXDXXPXXDXXXXXXDDXX
XXXXXXXXXXXXXXXXXXXXXXXXXX