[LEVEL]
XX XXXXXXXXXXXXXXX    E XX
XX XXXXCXXXXXXXXXX XXCXXXX
XX XXXDDXXXXXDXXXX XXXXXXX
XX CXXDDXXXXXDXXXX XXXXXXX
XXSXXXDDCXXXXDCXXX XXDDDXX
XX XXXDDXXXXXDXXXX XXDDDXX
XX XXXDDXXXXXDXXXX XXDDDXX
XX  XXXXXXXXCXCXXX XXXXXXX
XXX XXXXXXXXXXXXXX XXXXXXX
XXX B   XXXXXXXXXX XXXXXXX
XXXXXXX XXXXXXXXXX XXXXXXX
XXDXXXX XXXXXXXXXX XXXXDXX
XXDDXXX      P     XXXDDXX
XXXXXXXXXXXXXXXXXXXXXXXXXX
[LEVEL]
XXXXXXXXXXXXXXXXXXXXXXXXXX
XX   E     XXXXCXCXXXX SXX
XXXXXXXXXX XXXXXXXXXXX XXX
XXXDDXXXXX XXXDDDDDXXX XXX
XXXDDXXXXX XXXDDDDDXXX XXX
XXCDDCXXXX XXXXXXXXXXXBXXX
XXDDDDXXXX XXXXXXXXXXX XXX
XXDDDDXXXX XXXCXXXXXXX XXX
XXXDDXXXXX XXXDDXXX    XXX
XXXCCXXXXX XXDDDDXX XXXXXX
XXXXXXXXXX XXXDDXXX XXXXXX
XXDXXXXXXX XXXXXXXX XXXXXX
XXDDXXXXXX    P     XXXXXX
XXXXXXXXXXXXXXXXXXXXXXXXXX
[LEVEL]
XXXXXXXXXCXXCXXXCXXXXXXXXX
XX  S   XXXXXXXXXX   E  XX
XXDDXXX XXDXXXDXXX XXCCXXX
XXDXXXX XXDXXXDXXX XXDDXXX
XXXCCXX XXDXXXDXXX XDDDDXX
XXDDDDX XXDXXXDXXX XDDDDXX
XXDDDDX XXDXXXDXXX XXDDXXX
XXXDDXX     B      XXDDXXX
XXXDDXXXXXXX XXXXXXXXXXXXX
XXXXXXXXXDXX XXDXXXXXXXXXX
XXXXXXXXXDXX XXDXXXXXXXXXX
XXDXXXXXXDXX XXDXXXXXXXDXX
XXDDXXXXXDXXPXXDXXXXXXDDXX
XXXXXXXXXXXXXXXXXXXXXXXXXX
[LEVEL]
XXXXXXXXXXXXXXXXXXXXXXXXXX
XX  E     XXXXXX     S  XX
XX XXXCXX XXXXXX XXCXXX XX
XX XXXDDX XXXXXX XDDXXX XX
XX XXXDDX   XX   XDDXXX XX
XX XXCXXX XXXXXX XXXCXX XX
XX XXXXXX XXDDXX XXXXXX XX
XX XXXXXX XXDDXX XXXXXX XX
XX   B    XXXXXX    B   XX
XXXXXXXXX XXXXXX XXXXXXXXX
XXXXXXXXX XXXXXX XXXXXXXXX
XXDXXXXXX XXXXXX XXXXXXDXX
XXDDXXXXX   P    XXXXXDDXX
XXXXXXXXXXXXXXXXXXXXXXXXXX
[LEVEL]
XXXXXXXXXXXXXXXXXXXXXXXXXX
XX  S  XXCXXXXXXCXX  E  XX
XXX XX XXXXXXXXXXXX XX XXX
XXX XX XXDDXXXXDDXX XX XXX
XXX XX XXDDXXXXDDXX XX XXX
XXX XX XXXXXXXXXXXX XX XXX
XXXC   XXXXX  XXXXX   CXXX
XXXXXXX XXX    XXX XXXXXXX
XXXXXXX XX  B   XX XXXXXXX
XXXDDXX XX XXXXXXX XXDDXXX
XXXDDXX    XXXXXXX XXDDXXX
XXDXXXXXXX XXXXXXX XXXXDXX
XXDDXXXXXX    P    XXXDDXX
XXXXXXXXXXXXXXXXXXXXXXXXXX
[LEVEL]
XX  XXXXXXXXCXXXXXXXXX  XX
XX E   XXXXDDXXXXXX   S XX
XXXXXX XXXXDDXXXXXX XXXXXX
XXXXXX XXXXXXXXXXXX XXXXXX
XCX    XXXXDDXXXXXX    XCX
XXX XXXXXXXXXXXXXXXXBXXXXX
XXX XXXXXXXXXXXXXXXX XXXXX
XXX    XXXXDDXXXXXX    XXX
XXXXXX XXXXXXXXXXXX XXXXXX
XXXXXX XXXXDDXXXXXX XXXXXX
XXXXXX     XXXX     XXXXXX
XXDXXXXXXX XXXX XXXXXXXDXX
XXDDXXXXXX  P   XXXXXXDDXX
XXXXXXXXXXXXXXXXXXXXXXXXXX
[LEVEL]
XXXXXXXXXXXXXXXXXXXXXXXXXX
XX  E     XXXXXX     E  XX
XX XXXXXX XXXXXX XXXXXX XX
XX XXDDXX XXCCXX XXDDXX XX
XX XXDDXX XXCCXX XXDDXX XX
XX XXXXXX XXXXXX XXXXXX XX
XX                      XX
XX  S     XXXXXX     S  XX
XX XXXXXX XXDDXX XXXXXX XX
XX XXDDXX XXDDXX XXDDXX XX
XX XXXXXX XXXXXX XXXXXX XX
XX           B          XX
XXXXXXXXXX  P   XXXXXXXXXX
XXXXXXXXXXXXXXXXXXXXXXXXXX
[LEVEL]
XXCXXXXXXXXXXXXXXXXXXXXCXX
XX                     SXX
XXXXXX XXXXXXXXXX XXXXXXXX
XXDDXX XXDDXXXXXX XXDDXXXX
XXDDXX XXDDXXXXXX XXDDXXXX
XX   E XXXXXXXXXX XXXXXXXX
XXXXXXXXXX           B XXX
XXXXXXXXXX XXXXXXXXXX  XXX
XXDDXXXXXX XXDDXXXXXX XXDX
XXDDXXXXXX XXDDXXXXXX XXDX
XX    S    XXXXXXXXXX XXDX
XXXXXXXXXXXXXXXXXXXXX XXDX
XX         P          XXDX
XXXXXXXXXXXXXXXXXXXXXXXXXX
[LEVEL]
XXXXXXXXXXXXXXXXXXXXXXXXXX
XX          B           XX
XX CXX XXXXXXXXXXXX XXC XX
XX DXX XXDDXXXXDDXX XXD XX
XX DXX XXDDXXXXDDXX XXD XX
XX XXXXXXXX    XXXXXXXX XX
XX XXXXXXXX S  XXXXXXXX XX
XX XXXXXXXX    XXXXXXXX XX
XX DDXX   XXXXXX   XXDD XX
XX DDXX E XXXXXX E XXDD XX
XX XXXXXX XXXXXX XXXXXX XX
XX        XXXXXX        XX
XXXXXXXXXX  P   XXXXXXXXXX
XXXXXXXXXXXXXXXXXXXXXXXXXX