[LEVEL]
XX XXXXXXXXXXXXXXX      XX
XX XXXXCXXXXXXXXXX XXCXXXX
XX XXXDDXXXXXDXXXX XXXXXXX
XX CXXDDXXXXXDXXXX XXXXXXX
XXEXXXDDCXXXXDCXXX XXDDDXX
XX XXXDDXXXXXDXXXX XXDDDXX
XX XXXDDXXXXXDXXXX XXDDDXX
XX  XXXXXXXXCXCXXX XXXXXXX
XXX XXXXXXXXXXXXXX XXXXXXX
XXX     XXXXXXXXXX XXXXXXX
XXXXXXX XXXXXXXXXX XXXXXXX
XXDXXXX XXXXXXXXXX XXXXDXX
XXDDXXX      P     XXXDDXX
XXXXXXXXXXXXXXXXXXXXXXXXXX
[LEVEL]
XXXXXXX      XXXXXXXXXXXXX
XXDDDXX XXXX XXCXXXXXXXXXX
XXDDDXX XXXX XXDXXXX   XXX
XX   XX XXXX XXXXXXX X XXX
XXXX XX CXXX      XX X CXX
XXXX XXXXXXX XXXX XX X XXX
XXC       XX XXXX XX X XXX
XXXXX XXX XX XXXX    X XXX
XXDXX CXX XX XXXXXXXXX XXX
XXDXX XXX XX     E     XXX
XXDXX XXX XXXXXXXXXXXXXXXX
XX    XXX   C   D      XXX
XXXXXXXXXXXXXXX P XXXXXXXX
XXXXXXXXXXXXXXXXXXXXXXXXXX
[LEVEL]
XX      C      C        XX
XX XXXXXXXXXXXXXXXXXXXX XX
XX XXD C      C     DXX XX
XX XXD XXXXXXXXXXXX DXX XX
XX XX  XXXX DD XXXX  XX XX
XX XX XXXXC DD CXXXX XX XX
XX XX XXXX  DD  XXXX XX XX
XX C  XXXX XXXX XXXX  C XX
XXXXX XXXX X  X XXXX XXXXX
XDDD       X  X       DDDX
XDDD XXXXXXX  XXXXXXX DDDX
X    XX E        P XX    X
XXXX XX            XX XXXX
XXXXXXXXXXXXXXXXXXXXXXXXXX